############################
#o...........##...........o#
#.####.#####.##.#####.####.#
#.#..#.#...#.#.#.#...#.#..#.#
#.####.#####.##.#####.####.#
#..........................#
#.####.##.########.##.####.#
#......##....##....##......#
######.##### ## #####.######
#    #.##         ##.#    #
#    #.## ###  ### ##.#    #
######.## #      # ##.######
      .   #      #   .      
######.## ######## ##.######
#    #.##         ##.#    #
#    #.## ######## ##.#    #
######.## ######## ##.######
#o...........##...........o#
#.####.#####.##.#####.####.#
#...##.......  .......##...#
###.##.##.########.##.##.###
#......##....##....##......#
#.##########.##.##########.#
#..........................#
############################