############################
#............##............#
#.####.#####.##.#####.####.#
#o####.#####.##.#####.####o#
#.####.#####.##.#####.####.#
#..........................#
#.####.##.########.##.####.#
#.####.##.########.##.####.#
#......##....##....##......#
######.##### ## #####.######
     #.##### ## #####.#     
     #.##    --    ##.#     
     #.## ###  ### ##.#     
######.## #      # ##.######
      .   #      #   .      
######.## #      # ##.######
     #.## ######## ##.#     
     #.##          ##.#     
     #.## ######## ##.#     
######.## ######## ##.######
#............##............#
#.####.#####.##.#####.####.#
#.####.#####.##.#####.####.#
#o..##.......  .......##..o#
###.##.##.########.##.##.###
###.##.##.########.##.##.###
#......##....##....##......#
#.##########.##.##########.#
#.##########.##.##########.#
#..........................#
############################
